 _______________________________
|                               |
|                               |
|          Welcome in           |
|           EDIDSGame           _
|               0
|              /|\
|              / \              _
|                               |
|                               |
|_______________________________|