  ______|    |__________________
 |                              |
 |                              |
 |              0               |
 |             /|\              |
 |             / \              |
 |                              |
 |                              |
 |____________     _____________|
              |    |