  ___________________|____|_____ 
 |                              |
 |                              |
 |                              |
 |              0               |
 |             /|\              |
 |             / \              |
 |                              |
 |                              |
 |______________________________|
              |    |