  ___________________|____|_____ 
 |                              |
 |                              |
 |                              |
 |                              |
 |                              |
 |                              |
 |                              |
 |______________________________|
              |    |