 ___________________________________
|                 __               |
|                |__|              |
|                 __               |
|                |__|              |
|                 __               |
|                |__|              |
|                                  |
|__________________________________|