 ______________________________
|_|                          |_|
|                              |
_              0               _
              /|\
_             / \              _
|                              |
|_                            _|
|_|__________________________|_|