_______|--|_____
|               |
|               |
|               |
|               |
|               |
|       _  _    |
|      (_)(_)   |
|               |
|_______________|