  ______________________ 
 |                      |
 |           0          |
_|          /|\         |_
            / \
_                        _
 |      _/\_/|_/\_|\_   |
 |                      |
 |______________________|