  ______________________ 
 |                      |
 |                      |
_|                      |_
 |                      |
_|                      |_
 |      _/\_/|_/\_|\_   |
 |                      |
 |______________________|