 _______|____|    |_____|_______
|                               |
|             /\    A           |
|     0      / /\  / \          |-
|    /|\   _/ /  \/   \     C[] |
|    / \  /  /     /\            |-
|                               |
|              C[]              |
|_____________|---|_____________|