 _______________ 
|               |
|    ~~~~~~~~   |
|    ~~~~~~~~   |
|       0       |
|      /|\      |
|      / \      |
|               |
|_____|    |____|