_______|--|_____
|               |
|               |
|       0       |
|      /|\      |
|      / \      |
|       _  _    |
|      (_)(_)   |
|               |
|_______________|