  ______________________
 |                      |
 |                      |
_|                      |_
 |                      |
_|                      |_
 |     _|_|_|__|_|__    |
 |                      |
 |______________________|