  ______________________________ 
 |                              |
 |                              |
 |              0               |
 |             /|\              |
 |             / \              |
 |                              |
 |                              |
 |______________________________|
             |     |