  ______________________________ 
 |                              |
 |                              |
 |                              |
 |                              |
 |                              |
 |                              |
 |                              |
 |______________________________|
             |     |